9 15
###############
#    S        #
# S       S   #
#    S      L #
#             #
#######D#######
#             #
#E   K  A A   #
###############
