9 15
###############
# L  D        #
######        #
#          K  #
#          K  #
#          K  #
# E  AAA   K  #
#             #
###############
